浙江农林大学	浙江	杭州
丽水学院	浙江	丽水
宁波大学	浙江	宁波
绍兴文理学院	浙江	绍兴
浙江师范大学	浙江	金华
浙江师范大学行知学院	浙江	兰溪
浙江理工大学	浙江	杭州
中国计量大学	浙江	杭州
浙江工商大学	浙江	杭州
苏州科技大学	江苏	苏州
浙江万里学院	浙江	宁波
浙江海洋大学	浙江	舟山
深圳北理莫斯科大学	广东	深圳
南京邮电大学	江苏	南京
温州医科大学	浙江	温州
四川外国语大学	重庆	重庆
浙江海洋大学	浙江	舟山
嘉兴学院	浙江	嘉兴
浙大宁波理工学院	浙江	宁波
东北财经大学	辽宁	大连
浙大宁波理工学院	浙江	宁波
东北电力大学	吉林	吉林
东华大学	上海	上海
韶关学院	广东	韶关
浙江工商大学杭州商学院	浙江	桐庐
浙江水利水电学院	浙江	杭州
武汉工程科技学院	湖北	武汉
